Moped před schody vedoucí k ruinám.	Moped před ruinami.
Dívka hrající si v louži s bosýma nohama.	Dítě si hraje se dvěma bílými a černými husami.
Dítě jde od jednoho piknikového stolu, k druhému.	Chlapec v parku hopsá z jednoho piknikového stolu na druhý.
Hráč baseballu hází míček.	Hráč basketbalu drží míč.
Bílý pes běží skrz vodu na pláži.	Bílý pes běží skrz vodu na pobřeží.
Muž veslující na lodi.	Muž dělající triky na skateboardu.
Pes s klackem následuje jiného psa přes vodu.	Auto s pohonem na čtyři kola jede bahnem.
Žena čte, zatímco je ve veřejné dopravě.	Muž, který usnul ve veřejné dopravě.
Hnědobílá kočka stojící v trávě na straně u cesty.	Hnědobílá kráva stojící na travnaté ploše se stromy v pozadí.
Muž v neoprenu hází dítě v neoprenu do vzduchu.	Tancující muž v bílé potisknuté košili a tancující žena v černých šatech.
Dva psi běží bok po boku po trávě.	Dva psi běžící po trávě.
Muž na ulici venčí dva psi na vodítku.	Muž ve městě venčí dva psi.
Dva lidi na golfovém kurzu hrají golf.	Dva lidi jsou na golfovém kurzu a hrají golf.
Rodina si na pláži hraje s jejich psem.	Malá nahatá holčička je házená do vzduchu.
Muž v obleku tancuje s mladou dívkou před publikem.	Žena visí na modré látce, která drží na stromu.
Hnědý pes jde po trávě.	Pes honící jiného u stromu.
Hnědý kůň stojí na luxusním zeleném poli.	Hnědý kůň na zeleném poli.
Zlatosrstý pes běží na trávě.	Velký béžový pes běží trávou.
Chlapec skáče do vody s míčem v ruce.	Malý chlapec plavoucí pod vodou s hračkou v ruce.
Černé vozidlo zaparkované s výhledem na nízko položené hory.	Černé auto zaparkované ve špíně na venkově.
Blondýna má nasazenu černou kšiltovku s americkou vlajkou.	Zrzka má nasazený černý baret ozdobený americkou vlajkou.
Žena držící noviny.	Muž na kolečkových bruslích na kovové tyči.
Dítě drží objekt, který je v jednom ohni.	Dítě v růžovém má objekt, který se zdá být v jednom ohni.
Člověk jede na kole po stezce vedle lesa.	Malé dítě v žlutém tričku drží ruce na bocích.
Pes skákající přes překážku.	Pes skáče přes překážku.
Čtyři černí psi běží přes trávu.	Pes běží přes travnaté pole.
Chlapec a bílý pes běžící v travnatém poli.	Chlapec a pes běžící na trávě.
Mladý chlapec v červených plavkách skáče do bazénu.	Pes je stříkán hadicí, zatímco skáče do brouzdaliště.
Dva hokejoví hráči zápasící na ledu.	Dva hokejoví hráči zápasí na ledu.
Člověk držící síť stojí ve vodě.	Černoška a dvě černé děti sedí v doškovém stanu.
Muž v šedém obleku klečí před ženou v bílých šatech.	Ženu v červeném s pivem následuje muž v bílém.
Dva psi si společně hrají na pláži.	Dva černí psi si hrají v trávě.
Červený doubledecker na přeplněné ulici.	Doubledecker v ulici města.
Pes skáče do vody.	Pes skáče do vody.
Hnědočerná jídelní místnost zabudovaná v malém apartmánu.	Hnědočerný stůl v obývacím pokoji.
Dva béžoví psi si hrají v trávě.	Dva žlutohnědí psi si hrají v trávě.
Černý pes běží za bílým psem ve sněhu.	Černý pes pronásleduje hnědého psa sněhem.
Žena v červené teplákové soupravě vymačkávající citróny v lisu.	Mladá žena v růžové kapuce, fotí snímek.
Ovce stojící na poli.	Ovce pasoucí se na poli.
Dáma v kimonu se dívá do kamery.	Dvě dívky oblečené v černém sedí v místnosti a dělají sugestivní pózy na kameru.
Hnědý pes se chystá chytit zelený létající talíř.	Hnědý pes čeká, až zelený létající talíř klesne, aby ho mohl chytit.
Žena držící malé dítě.	Usmívající se žena drží malé dítě.
Žena v šedém tričku se usmívá na foťák zatímco žena za ní dělá pošklebky.	Žena s překvapeným pohledem ve tváři objímá usmívající se ženu zezadu.
Dvě štěňata hrající si kolem v trávě.	Dvě štěňata si hrají v trávě.
Pes běží skrz dlouhou trávu.	Pes leží v dlouhé zelené trávě.
Žena oblečená v růžovém tričku skáče do vzduchu s roztaženýma rukama a nohama.	Muž v kšandách a slunečních brýlích vyskakuje do vzduchu s roztaženýma rukama a nohama.
Psi si hrají ve sněhu na zadních nohách.	Dva psi si hrají ve sněhu.
Tři psi běžící v blátě.	Žlutý pes běží po blátivé cestě.
Pes běží trávou.	Pes běží sněhem.
Dvě dívky jsou v kalhotách od pyžama a vypadá to, že tancují.	Dvě dívky v kšiltovkách jí venku svačinu.
Bílý pes běží na pláži.	Bílý pes běží po pláži.
Muž v červené bundě drží své kolo pro fotku.	Žena v červené bundě nahrává na video přírodu.
Jeden chlapec tlačí dalšího chlapce na houpačce.	Chlapec tlačí jiného chlapce na houpačkách.
Tří děti hrající si ve sněhu.	Tři děti hrající si v seně.
Skupina lidí v lodích závodících k pobřeží.	Skupina lidí stojí spolu a pózují před domem.
Žena hrající si se dvěma chlapci v parku.	Žena a tři děti si hrají v parku.
Dívka si hraje v hromadě barevných míčků.	Holčička si hraje v díře plné barevných míčků.
Mladý chlapec skákající do bazénu, kde je zákaz skákání.	Chlapec skáče do bazénu, zatímco plavčík dává pozor.
Bílý načechraný pes běží v čistě bílém sněhu.	Načechraný, bílý pes běžící ve sněhu.
Krvavý muž a žena pózují pro obraz.	Muž a teple oblečená žena pózují pro obraz.
Žena drží psa, zatímco jiný pes stojí poblíž v poli.	Dáma držící jednoho psa, zatímco jiný pes si hraje ve dvoře.
Chlapec v červeném skákající do pískoviště.	Pes plavající v rybníku.
Dva lidé v kloboucích sedí a dívají se do foťáku.	Muž v modrém tričku dělá nabručenou tvář.
Dva vlaky, zelený a bílý stojí na kolejích.	Dva vlaky, zelený a bílý na kolejích.
Pes ve sněhu skákající pro létající talíř.	Pes skáče ve sněhu.
Skupina mladých baletek je v tanečním studiu.	Skupina mladých dam v bikinách.
Dva lidé jdou nějakou vodou.	Dvě dívky jdou u stromu před cihlovou stavbou.
Velký bílošedý pes běží skrz žlutý tunel na překážkové dráze.	Bíločerný pes vybíhá ze žlutooranžové trubky.
Dva psi bojující ve sněhu.	Dva psi stojící ve sněhu.
Černý pes skáče přes vodu.	Pes jde přes sníh.
Dvě malé dívky v růžové tancují.	Dvě dámy běžící pro zdraví na cestě v blízkosti nábřeží.
Muž v modré čepici sedí na stoličce pod stromem.	Pes stojící na pláži s míčem poblíž.
Černý pes s modrým obojkem běží ve sněhu.	Černý pes v modrém obojku běží sněhem.
Velký béžový pes běží se zeleným předmětem v tlamě.	Béžový pes nese zelenou pískací hračku v tlamě.
Muž spí s dítětem v klíně.	Spící muž na židli držící dítě.
Tři psi si hrají ve vodě.	Tři psi plavou ve vodě.
Hokejový hráč se upřeně dívá dolů.	Hokejový hráč v průběhu hry.
Dívka s rukama ve vzduchu sedí na zádech muže, který leží na dece.	Dítě běží opačným směrem od ostatních dětí, které hrály hru.
Pes běžící sněhem.	Pes běží ve sněhu.
Psi si hrají ve sněhu.	Dva psi hrající si na pobřeží.
Dítě klouzající se ve sněhu.	Muž spící na ulici.
Tři děti se smějí a hrají si na podlaze.	Tři děti hrající si na podlaze.
Žokej jedoucí na koni v ohradě.	Žokej jede cvalem na koni.
Pes běžící po pláži.	Chlapec a dívka běžící po pláži.
Černý pes plavoucí přes řeku.	Černý pes prokopávající se sněhem.
Mladá dívka dělající salto pozadu do vody.	Mladá dívka ve fialovém běžící vodou.
Žena v modrém tričku a žlutohnědých kraťasech sedí u stolu.	Usmívající se mladá žena v tyrkysovém tričku a šátku u stolu.
Šedobílá a mourovatá kočka spící na fialové látce.	Černobílá kočka spící na hnědé plachtě.
Černý pes běží sněhem.	Řidič závodního auta jede se svým autem skrz bláto.
Dva lidé sedí na konci doku.	Dva lidé sedící v doku.
Červený doubledecker jedoucí skrz ulice.	Doubledecker jedoucí s dopravou.
Dítě skáče do bazénu.	Pes skákající do bazénu.
Hnědý pes stříkající vodu všude otřepáváním vody ze sebe.	Bílý pes stojí u řeky, otřásající se do sucha.
Pes běží na hnědé trávě.	Mokrý pes s tenisákem běží přes žlutou trávu.
Pes a červený míč ve vzduchu.	Pes kope díru na dvorku.
Pes cákající ve vodě.	Pes cáká v kalné vodě.
Pták letí přes vodu.	Pták letí nad vodou.
Skupina lidí v lodích závodících ke břehu.	Učebna studentů sledujících prezentaci.
Zlatý retrívr skákající z dřevěné verandy.	Zlatý retrívr skáče z dřevěné verandy.
Hnědobílý pes běží vodou.	Dva psi, běžící vodou.
Dítě v modrobílém dresu běží za fotbalovým míčem.	Mladý chlapec v modrém fotbalovém dresu běží za míčem.
Lyžař padá do sněhu.	Lyžař padá obličejem do sněhu.
Čtyři děti si hrají na trampolíně.	Čtyři děti skáčou na trampolíně.
Muž a žena se usmívají.	Smějící se muž a žena.
Muž jedoucí na kole na pláži u oceánu.	Muž jdoucí se svou krávou po straně silnice.
Bílo hnědý pes hrající si s černou hračkou.	Bílo hnědý pes se přetahuje na laně.
Muž v tričku s nápisem "Gigolo" stojí u pultu a s někým mluví.	Muž v tričku s nápisem "Gigolo" stojí na recepci zády ke kameře.
Starší muž stojí venku před nákladním autem.	Žena oblečená v zeleném jezdí venku na kolečkových bruslích na nějaké akci.
Žena na pláži stavící dítě na skateboard.	Žena na pláži drží malé dítě na skateboardu.
Dva muži bez domova stojí venku s lepenkovou značkou.	Dva mladí muži bez domova držící lepenkovou značku.
Muž na laně leze po strmé skále.	Mladý muž skáče na fialovém snowboardu.
Skateboardista na ulici ve městě.	Skateboardista ve vzduchu na velké, venkovní rampě.
Dva muži na straně člunu.	Muž s dlouhými vlasy a s bradkou leží v trávě.
Dva psi si hrají na dvorku.	Dva psi si hrají na trávě.
Školní autobus jedoucí do kopce venkovskou cestou.	Závodní pomoc jedoucí sama špinavou cestou.
Pes běží naproti kameře.	Hnědobílý pes běžící na trávě.
Děti skákající na trampolíně.	Muž sjíždí oranžovou skluzavku.
Černobílý pes má klacek v tlapách.	Černý a bílý pes stojí na sněhu.
Tři delfíni skáčou v bazénu, před davem lidí.	Muž prezentuje před mnoha lidmi.
Dva psi aportují ve sněhu.	Dva psi si spolu hrají v trávě.
Dívka s modrým kýblem cáká pod molem.	Dívka v lyžařské bundě jde poblíž budov.
Muž a žena sledují dva psy.	Muž v kaštanovém koupacím obleku se houpe na laně na jezeře.
Snowboardista jede dolů po zábradlí vedle schodiště.	Chlapec jede na hraně skateboardu po betonové zdi.
Blondýna v bílém pózuje pro kameru.	Černobílý pes běží s otevřenou tlamou.
Hnědobílý pes plave v bazénu.	Hnědobílý pes plave v bazénu na dvorku.
Dva psi běží v poli.	Dva psi běžící v poli.
Černý pes jdoucí vedle bazénu.	Černý pes jde po straně bazénu.
Dvě děti cákající ve vodě.	Dva delfíni skákající do vody.
Pes plave s klackem v tlamě.	Pes běží s klackem v tlamě.
Dva psi aportují ve sněhu.	Dva psi si hrají ve sněhu.
Tři psi závodící na prašné dráze.	Auta závodící na prašné dráze.
Osobní vlak čekající ve stanici.	Osobní vlak stojí ve stanici.
Žena v černo oranžové bundě hází klacek hnědočernému psu jako aport.	Muž v modré bundě stojí v davu.
Čtyři dívky v plavkách hrají volejbal na pláži.	Čtyři ženy v bikinách hrají volejbal na pláži.
Dva černí psi skáčou ve sněhu a hrají si se žlutým tenisákem.	Hnědý a černý pes hrající si se žlutým fotbalovým míčem.
Hnědý pes honí frisbee.	Hnědý pes válející se na trávě.
Černý pes procházející vodou.	Dva černí psi procházející sněhem.
Zapřažený pes skáče přes kládu a další pes ho následuje.	Hnědobílý pes skáče přes kládu v poli a další pes ho následuje.
Hnědobílý pes chytá tenisák stojící na zadních nohách.	Hnědobílý pes nese klacek v tlamě.
Děti si hrají s míčem v parku.	Dva psi si hrají na břehu.
Mladí muži skáčou ze skály do jezera.	Mladý muž v červených plavkách skáče z velké skály do vody.
Lyžař skáče do vzduchu přes sněhové pole v blízkosti pohoří.	Žena sedí u záhonu s výhledem do tunelu.
Černý pes leží v písku.	Děti si hrají ve vodě.
Muž běžící na trati.	Běžící muž na trati.
Černý pes běží sněhem.	Černý pitbul běží blátem.
Osoba na sněžném skútru.	Osoba na sněžném skútru uprostřed skoku.
Pes skáče z doku do vody.	Černý pes skáče z doku do vody.
Pes skáče přes hnědou trávu.	Dva psi skáčou přes trávu.
Muž a žena na lavičce.	Muž a žena sedí v parku na lavičce.
Muž ve žlutém tričku na obličeji se zlatou sluneční maskou.	Muž ve žlutém tričku má na sobě zlatou masku ve tvaru slunce.
Dva Asiati a dvě Asiatky sedí v černých masážních křeslech.	Dva Asiati a jedna žena relaxují v masážních křeslech.
Usmívající se muž s reflexními brýlemi.	Gentleman se usmívá a ukazuje jeho reflexní sluneční brýle.
Muž a malé dítě v obýváku pózují na kameru.	Muž a žena pózují na kameru.
Dva velcí psi běží v nějaké trávě.	Dva žíhaní psi běží v trávě.
Mladá dívka s brýlemi sedí a drží dvě Americké vlajky.	Dívka v brýlích se dívá přes dvě Americké vlajky poblíž zalesněné oblasti.
Hnědý pes je uprostřed řady psů pronásledujících špinavý tenisový míč přes bláto.	Jsou tam dva bílí a jeden hnědý pes pronásledující míč.
Dva lidé jdoucí po pobřeží při západu slunce.	Dva lidé jdoucí po pláží při západu slunce, aby varovali skupinu lidí.
Skateboardista se pokouší udělat trik na kraji nízké zdi.	Chlapec na zábradlí dělá triky se skateboardem.
Dva psi si hrají v trávě.	Dva žlutohnědí psi si hrají ve sněhu.
Muž v džínách si hraje s míčem, zatímco žena stojící poblíž se dívá pryč.	Muž váže červenou pásku okolo ruky jiného muže na ulici.
Velký hnědobílý pes běží sněhem.	Bernardýn běžící zasněženým polem.
Dvě dívky skáčou vysoko do vzduchu.	Dva psi čichají jeden k druhému v trávě nedaleko jezera.
Pět lidí stojí na chodníku.	Pět lidí na chodníku.
Muž s dlouhými vlasy se dívá skrz fotoaparát.	Muž se slunečními brýlemi dívající se přímo před sebe.
Chlapec, který má na sobě červené tričko, běží přes trávu se zuřivým psem.	Sportovní fanoušek s pomalovaným obličejem stojí v písku.
Černý pes honí dva ptáky na břehu oceánu.	Pes běží podél pláže vedle oceánu.
Muž a žena s rukama na bradách stojí vedle Vánočního stromku.	Muž s bílou bradkou v modré čepici stojí u vchodu do dílny.
Malý chlapec hrající si ve sněhu.	Hnědobílý pes si hraje ve sněhu.
Čtyři děti, držící se za ruce skáčou do bazénu.	Čtyři psi hrající si ve sněhu.
Černý pes běžící ve sněhu.	Černý pes běžící na pláži.
Skupina malých děvčat a pes stojící na cestě.	Skupina lidí v modrém raftu jedoucí na divoké vodě.
Buldok běží přes travnatý park, zatímco lidé stojí v pozadí.	Pes s velkým tělem běží vodou a cáká kolem.
Hnědobílý pes běží sněhem.	Hnědobílý pes běží po trávě.
Pták sedí na stromě.	Pták sedí na bezlistém stromě.
Černobílý pes běží v travnaté zahradě obklopené bílým plotem.	Černobílý pes skáče přes překážky.
Muž v pánských plavkách stojí naproti nějaké skále.	Muž v šedém tričku leze po velké skalní stěně.
Tři psi běžící na závodní dráze.	Tří psi krouží po závodní dráze.
Dva teriéři si hrají na dřevěné podlaze u nich doma.	Dvě štěňata si hrají s červenou gumovou hračkou na hřišti.
Muž a žena foukají bubliny.	Muž a žena v brýlích foukají bubliny.
Dva psi běžící přes hřiště.	Dva psi si hrají na hřišti.
Dva psi hrající si s míčem v louži.	Dva psi stojí v louži a jeden má žlutý tenisový míček.
Modrý a bílý fotbalový tým hrající proti sobě.	Žena nahoře bez s namalovaným obličejem je pokrytá blátem.
Oranžová mourovatá kočka spí na gauči.	Muž dívající se na TV s nohou na posteli.
Pes běží trávou.	Dva psi běží křovím.
Hnědý pes běží přes zelenou trávu.	Hnědý pes běží přes řeku.
Černý pes běží v trávě.	Chlapec běžící skrz zelenou trávu.
Žena a muž jsou rozptýleni sluchátky.	Muž a žena odpočívající po cvičení.
Jeden muž v oranžovém tričku na sobě bílou helmu jede na kole.	Muž, který má na sobě modrou přilbu, jede v Polarisu.
Dva lidé jedou na kolech dolů po polní cestě.	Dva lidé jedoucí na kolech na kopci.
Černobílý pes plave v řece.	Černoch a jeho pes na pláži.
Skupina lidí je ve vodě.	Skupina lidí jede závod.
Člověk v červené vestě se dotýká modrých bruslí na jiné osobě.	Dáma ve sněhu zavazuje něčí brusle.
Skateboardista, se dostal na vrchol rampy.	Skateboardista, jede na trubkové zdi ve skateparku.
Dva psi čůrají na červený požární hydrant.	Dva psi močí na červený požární hydrant.
Žena jí ryby v restauraci.	Žena jí velkou rybu v restauraci.
Bílý pes běžící na písku.	Bílý pes běží na písku.
Černý pes jde vysokou trávou.	Černý pes běží v trávě.
Pes běžící přes sníh se sněhovou koulí v tlamě.	Žlutohnědý pes běží trávou se žlutou hračkou v tlamě.
Dav lidí stojí na venkovské cestě, s polem za nimi a lesem před nimi.	Skupina lidí stojící vedle auta s otevřeným kufrem.
Chrt číslo dva běží po dráze.	Chrt s náhubkem běží po dráze.
Dva psi na dvorku.	Dva psi v potoce.
Žena stojí s pažemi podél boků, zatímco jiná žena fotí.	Muž stojící v davu držící bílý objekt.
Tři psi si hrají v travnatém poli.	Nějaké děti si hrají v poli.
Malý bílý pes s vodítkem skákající po červeném míči.	Černobílý pes vrací hůl ve sněhu.
Hnědá kráva s rohy stojící na poli.	Hnědý kůň stojící uprostřed travnatého pole.
Hráč softbalu odpalující na hřišti.	Hráč baseballu trefující míček.
Mladá dívka sedí Santovi na klíně.	Malá dívka sedí Santovi na klíně.
Hnědočerný pes sprintuje přes sníh.	Černý pes rychle běží po zemi.
Dívka má na sobě modré proužkované tričko a kolečkové brusle.	Muž v černobílé košili skákající na psím hřbetu.
Černobílé foto staré vlakové stanice.	Černobílé foto motorky ležící na zemi.
Černobílá kočka je vysoko na třech větvích.	Černobílé jehně se značkou v pravém uchu.
Tři děti zápasí na květinovém koberci.	Tři děti hrající si na podlaze.
Osobní vlak ve sněhu.	Osobní vlak čeká ve stanici.
Žena u jídelního stolu si píše do sešitu.	Žena u stolu je něčím zaneprázdněna.
Dívka dělá most na pláži.	Dívka dělající most na pláži.
Černoch v černočerveném spí na lavičce s otevřeným deštníkem.	Muž sedící na lavičce v parku dávající si šlofíka s otevřeným deštníkem, který ho chrání před sluncem.
Mladý muž jezdí na skateboardu ve skateparku.	Chlapec v modrém tričku je ve vzduchu na skateboardu ve skateparku.
Černobílý pes skáče přes překážku.	Bílý pes běžící přes most.
Dva hubení chlapci hrající si s pískem ve vodě.	Dva psi oklepávají vodu.
Člověk se dvěma lyžařskými hůlkami sjíždí zasněžený kopec.	Člověk na lyžích sjíždí zasněžený kopec.
Dívka ve fialovém tričku a v růžové čelence pózuje.	Mladá dívka v klobouku a modrých džínách je na houpačce.
Pes běží přes písek s klackem v tlamě.	Pes běží skrz potok s klackem v tlamě.
Dva hnědí psi běžící spolu na písku.	Dva hnědí psi běží na písku.
Pes běží přes rybník.	Bledý pes běží po prašné cestě.
Hnědý pes skákající do vzduchu, aby chytil míč.	Tři mladé ženy skákající do vzduchu, aby chytily míč.
Muž v černém obleku surfuje sám po ničivých vlnách.	Surfař v černém potápěčském obleku jede na bílé vlně v oceánu.
Lezec stojí na skále s obličejem vedle růžového lana.	Děti běžící ve sněhu s ohradami v pozadí.
Skateboardista provádí trik na potrubí.	Skateboardista se snaží udělat trik na domácky vyrobené rampě.
Pes nese vodítko v tlamě.	Načechraný pes nese černé vodítko v tlamě.
Žokej jedoucí na koni.	Žokej jedoucí na koni v ohradě.
Černý pes s modrým obojkem běží ve sněhu.	Černý pes s červeným obojkem si hraje ve sněhu.
Skupina lidí jde po chodníku z velkoměsta.	Skupina lidí jede v zadní části kamionu.
Chlapec na skateboardu sjíždí zábradlí u schodů pomalovaných graffiti.	Skateboardista skáče přes překážku před bílým domem.
Dva psi ve sněhu.	Dva psi si hrají v trávě.
Pes plave ve vodě.	Tři psi plavou ve vodě.
Pes skáče do vzduchu, aby chytil hračku.	Černý pes, skočí do vzduchu, aby chytil hračku.
Dívka běží se psem po suchém poli.	Šedý pes a žlutohnědý pes hrající si na travnatém poli.
Muž s kolem v kavárně.	Muž vedoucí kolo na terasu kavárny.
Dva orli sedí na větvi.	Dva vypelichaní orli na větvi.
Dva velcí psi si hrají v travnatém poli.	Dva bílí psi společně běží.
Chlapec skáče do ne tak přeplněného veřejného bazénu.	Muž skáče, zatímco je na snowboardu.
Černý pes jde po trávě s klackem v jeho tlamě.	Černý pes běží po trávě s hračkou v jeho tlamě.
Muž sedící na veřejnosti jí jablko.	Muž na veřejném prostranství jí jablko.
Pes běží ve sněhu.	Dva psi běžící v blátě.
Žena a pes stojící v trávě.	Muž drží znak, zatímco stojí v dešti.
Muž v červeném tričku leze po boku hory.	Muž leze po boku hory.
Mladá dívka s úsměvem s hlavou vzhůru nohama.	Dívka pózuje s hlavou vzhůru nohama.
Muž a pes se hrají přetahovanou s lanem.	Muž tančí na barevné zdi.
Čtyři děti na stoličkách u večeře.	Čtyři děti sedí na vysokých barových stoličkách u žlutošedého baru.
Muž s poštovní brašnou před šedou dlaždicovou stěnou.	Muž v červené bundě stojící před majákem.
Malá dívka v červeném tričku táhne papírového draka.	Dívka v červeném tričku fotí fotku mobilem.
Muž v červených kraťasech a bílém tričku vykopávající fotbalový míč.	Černý pes na surfu držící červený gumový míč.
Skupina sedmi lidí jede na zeleném raftu v peřejích.	Skupina lidí v noci stojí a sedí v kolečku na zemi.
Pes kluše trávou.	Pes cválá trávou.
Bíločerný pes skáče do bazénu.	Žena v černé zástěře stojí před zrcadlem.
Dvě bílé krávy na zelené pastvě.	Žlutohnědý kůň je na pastvě.
Černý pes se vynoří z vody s bílým míčem v tlamě.	Černý pes vylézá z vody s bílým míčem v tlamě.
Muž v červených plavkách hrající volejbal.	Muž a žena sedící na motorce.
Muž a žena stojí před budovou.	Dvě dívky sedí na ATV na písku před mostem.
Hnědobílý pes se prochází v mělkých vodách.	Bílo hnědý pes vypadá, že jde po vodě.
Chlapec sjíždí kopec na červených sáňkách.	Mnohobarevný pes s červeným obojkem se krčí v trávě.
Parník zakotvil u pobřeží.	Parník zakotvil u břehu.
Dívka běží po pouštní cestě.	Mladá dívka mluví do mobilního telefonu.
Smějící se muž a žena.	Muž a žena se líbají.
Muž v oranžovém kabátu mluví na druhého muže, zatímco procházejí sněhem.	Muž a žena ve staromódním oblečení sedí venku u stolu.
Některé děti zvedají ruce a tleskají.	Tři děti hrají fotbal na písku.
Muž stojí ve vodě poblíž vodopádu.	Muž se brodí ve vodě a sleduje padající vodu.
Muž jede na motorce dolů po silnici.	Muž jede po silnici na červené motorce.
Postavený stan s koněm v pozadí.	Černobílé jehně s ostatními jehňaty v pozadí.
Pes stojí v písku.	Bronzový pes stojí před nějakou rostlinou.
Muž v červených kraťasech nesoucí hůl jde podél kamenů u řeky.	Muž jde po kamenech kolem, kterých protéká voda.
Děti si hrají na boj s meči.	Dítě a rodič se mazlí s koněm.
Potetovaný muž v černém hrající na bílou kytaru a zpívá.	Žena v černobílém plášti a chrániči sluchu.
Černobílý pes běží trávou.	Černobílý pes běží na trávě.
Čtyři dívky v plavkách hrají volejbal na pláži.	Čtyři ženy v plavkách hrají plážový volejbal na pláži.
Skupina lidí jí venku u stolu.	Skupina postarších lidí sedí okolo stolu.
Člověk, který skáče na skateboardu do vzduchu nad rampu.	Motorkář jede podél trati prvku umístěného na zalesněné oblasti.
Pták přistane ve vodě.	Loď plave ve vodě.
Muž lezoucí po útesu.	Muž leze po strmém útesu.
Černobílý pes plave ve velkém zeleném jezeře.	Černý pes rychle běží v mělké vodě.
Žena a dva muži v čepicích seznamující se venku.	Mladá žena v pletené čepici stojí naproti zdi od obchodu s pizzou.
Pes běží směrem k fotoaparátu s míčem v tlamě.	Černobílý pes plave s hnědým objektem v tlamě.
Osoba s helmou jede na kole blízko bílé konstrukce.	Osoba s jezdeckou helmou na cestě mezi stromy.
Dva lidé se procházejí u oceánu.	Dva muži v ovčí vlně a v kloboucích dívající se do kamery.
Muž stojící na lodi přitahující druhou loď bambusovou holí.	Muž v černém klobouku stojící před cihlovou zdí a značkou.
Muž a žena jdou s bílým psem na vodítku.	Muž, žena a pes jdou po zpevněné cestě.
Dvě soutěžící provádí jejich psi na psí show.	Dvě ženy provádí jejích psi na psí show.
Dva černí psi hrající si v trávě.	Dva psi si hrají v trávě.
Chlapec vzhlíží k dívce, zatímco jiná dívka je ignoruje.	Chlapec se potápí v bazénu, zatímco ho pozoruje pár.
Dva psi běží přes trávu.	Tři psi běží ve sněhu.
Bílý pes běží skrz pole žlutých kytek.	Pes s červeným obojkem běží uprostřed zimy v lese.
Chlapec v černém mává rukama, zatímco ostatní jsou za ním na poli.	Muž v černém tričku jezdí na kolečkových bruslích kolem lavičky ve městě.
Dva psi hrající si na pobřeží.	Dva psi hrající si ve sněhu.
Muž sedící v přeplněné místnosti.	Muž leží v posteli v přeplněné místnosti.
Muž učí chlapce jezdit na kole.	Ten muž učí chlapce jezdit na kole.
Dvě děti v poli červených květin.	Dvě děti si hrají v poli červených květin.
Mnoho lidí je v cyklistickém závodu, včetně muže na tříkolce.	Muž jede na tříkolovém vozíku.
Pes skáče do vzduchu chytit frisbee.	Hnědý pes skáče pro růžové frisbee.
Malý pes běží přes překážkovou dráhu.	Malý pes skákající přes překážku.
Muž jde směrem k policistovi stojícímu na přechodu pro chodce na ulici ve městě.	Policista ve městě stojí na přechodu pro chodce.
Dvě dívky držící leták strašidelného filmu.	Dvě dívky držící pytle stojí v poli.
Dva ptáci škádlící se v trávě.	Dva psi si spolu venku hrají.
Muž a dva mladí chlapci skáčou na trampolíně.	Muž a dva chlapci se odrážejí na trampolíně.
Přiblížená, zkreslená fotografie prázdné skleněné láhve od koly.	Přiblížený obrázek stolu, na kterém je počítač a papíry.
Chlapec v noci sjíždí na skateboardu kovové zábradlí.	Hnědý pes běží na písku, držící klacek.
Černobílá kráva v seně.	Černobílá kráva v ohradě se senem.
Pes se vynořuje z vody s klackem v tlamě.	Pes běží naproti kameře s klackem v tlamě.
Usmívající se muž a holčička pózující pro fotku.	Usmívající se muž drží malé dítě oblečené v růžové a červené.
Potápěč ponořený ve vodě.	Potápěč je pod vodou.
Chlapec mává dokola prskavkou.	Mladý chlapec točí prskavkou kolem ve vzduchu.
Skupina starších mužů jdoucí ulicí.	Pár jdoucí ulicí.
Žena se pokouší jet na malé vlně.	Muž a žena sedící venku na sluníčku zády k sobě.
Malá bílá kočka se svítícíma očima je pod židlí.	Bílá kočka stojí na podlaze.
Tři psi běžící vodou.	Černý pes běžící vodou.
Velká loď ve vodě v přístavu.	Velká loď na moři.
Muž jede na windsurfu v oceánu.	Pes běží oceánem.
Pět mužů ve smokingu jde dolů po schodech.	Pět mužů ve smokingu jde dolů po schodišti.
Tři psi si hrají v bílém sněhu.	Dva psi si hrají v trávě.
Tři děti v jámě s míčky.	Několik dětí hrajících si v jámě s míčky.
Pytel bavlny před gaučem.	Kočka Kaliko sedící na schodu před dveřmi.
Pes běžící lesem v zimě.	Pes běžící skrz hodně větviček.
Děti hrají fotbal na hřišti.	Tři chlapci hrající fotbal na hřišti.
Pes hrabající v písku.	Hnědý pes hrabe v písku.
Dva muži na běžecké soutěži.	Psi v závodě.
Hnědý pes vyskakuje, aby chytil zelený pásek do jeho tlamy.	Šedý pes, skáče, aby skousl zelené vodítko.
Hnědý pes běžící skrz les.	Hnědý pes běží skrz trávu.
Pes běžící po trávě.	Dva psi běží po trávě.
Malý chlapec a malá dívka hrající si spolu venku.	Mladý chlapec a mladá dívka jdoucí naproti sobě.
Hnědý pes se brodí ve vodě.	Pes cáká v kalné vodě.
Tři psi hrající si ve sněhu.	Tři psi si hrají ve vodě.
Tři klauni v zářivých, mnohobarevných kostýmech.	Tři ženy v zářivých barevných šatech.
Dvě různá plemena hnědých a bílých psů si hrají na pláži.	Dva psi hrající si v písku na pláži.
Bronzové tele se žlutou značkou na uchu dívající se do foťáku.	Muž s brýlemi a dvěma plastovými flaškami v popředí.
Červenobílé závodní auto na blátivé závodní dráze.	Člověk jede na špinavém kole v závodě po blátivé dráze.
Muž na zasněženém kopci na lyžích s horami v pozadí.	Pes si užívá dovádění ve vodě s horami a pískem v pozadí.
Chlap a dvě dívky se usmívají do kamery.	Tři psi, jeden bílý a dva hnědí běží společně po travnatém poli.
Žluto hnědý pes vyskočí chytit tenisový míček.	Červený pes skočí a chytí tenisový míček do tlamy.
Nadhazovač na kopečku hází basebalový míček.	Chlapec ve středu hrací plochy při baseballu.
Dvě dívky jdoucí v oceánu.	Dvě dívky jdoucí po ulici.
Černý pes běží přes nějakou vodu.	Muž ve fotbalovém dresu běží s míčem v průběhu hry.
Skupina lidí sedících okolo stolu s jídlem.	Skupina lidí sedí okolo stolu s jídlem a pivem.
Světle zbarvený pes běží v trávě.	Pes běží přes trávu.
Pes běží trávou.	Pes běží přes trávu.
Černobílý pes běží po trávě.	Černo bílý pes plave v modré vodě.
Muž oblečený v oranžové vestě jede na kánoi v modré vodě.	Muž v oranžové bundě v písku zvedající ruce k nebi.
Hnědý pes cachtající se ve vodě.	Čtyři psi cachtající se ve vodě.
Muž pronásledoval psa snažícího se dostat skrz plot na hřiště.	Muž, pronásleduje svého černobílého psa na překážkové dráze.
Dvě ženy držící pestré vlajky u oranžového vozu.	Dvě dámy ve skrovném oděvu pózují vedle staromódního auta.
Detail kolibříka.	Detail letícího kolibříka.
Jelen skáče přes plot.	Jelen skákající přes plot.
Dvě mladé dívky v trávě se navzájem objímají.	Dvě mladé dívky na travnatém terénu se navzájem drží.
Hnědí a černí psi ve sněhu, ukazující zuby a štěkající na sebe.	Černý pes bojující s hnědým psem ve sněhu.
Dva psi běžící společně a jeden má kachní hračku v tlamě.	Černobílý pes jdoucí po trávě s dlouhým klackem v tlamě.
Dítě v červené košili, používá černý wakeboard, aby překonalo plážovou vlnu.	Muž v člunu, vesluje přes modrou vodu.
Černý pudl si hraje ve sněhu.	Černý pudl skotačí ve sněhu.
Chlapec sjíždí na skateboardu zábradlí na schodech pomalovaných graffiti.	Skateboardista sjíždí dolů po zábradlí na nohách.
Černobílý pes skákající do vzduchu, aby chytil létající talíř.	Černobílý pes skákající na dvorku.
Dva psi hrající si ve sněhu.	Dvě děti hrající si se psem.
Dva psi běžící ve sněhu.	Pes ležící ve sněhu.
Pes v autě.	Pes kouše do mopu.
Surfař dělá flip z vlny.	Surfař dělá flip na vlně.
Mladý chlapec lezoucí na skalní stěnu.	Pět chrtů závodí na pískové dráze.
Černohnědý pes žvýká velký klacek.	Černobílý pes hrající si v písku.
Černobílý pes plavající v bazénu.	Černobílý pes běžící s něčím v tlamě.
Kočka stojící na třech větvích.	Černobílá kočka je vysoko na třech větvích.
Skupina ovcí na poli.	Skupina koní pasoucí se na poli.
Muž stojí obkročmo na kole na skalnaté stezce u jezera.	Žena má na sobě bílou čelenku, fialové tílko a černé rukavice.
Čtyři psi stojí ve sněhu.	Čtyři psi hrající si ve sněhu.
Černobílý tečkovaný pes skáče přes potok.	Černobílý tečkovaný pes skáče přes malý proud vody.
Dýdžejka zvedá album Michaela Jacksona.	Dívka držící obrázek usmívajícího se Michaela Jacksona.
Dva šedí psi běží spolu přes zelený trávník.	Dva šedí psi běhají na zeleném trávníku.
Chlapec v oranžovém tričku hází míč.	Černobílý pes s náhubkem vyskakuje nad trávu.
Černobílý pes běží trávou.	Žlutohnědý pes jde sněhem.
Dívka si hraje s obrázky na velké obrazovce.	Tři dívky držící deštníky jsou natočeny zády k fotoaparátu.
Surfař na vlně.	Surfař sjíždí vlnu.
Dva psi hrající si ve sněhu.	Dva psi si hrají ve sněhu.
Pes plave přes vodu.	Pes s pláštěnkou běží sněhem.
Dívka vzhůru nohama se hlavou odráží na trampolíně.	Dívka se hlavou odráží na trampolíně.
Černý pes běží sněhem.	Černohnědý pes běží sněhem.
Dva psi běžící vysokou trávou.	Dva psi běží přes travnatou plochu.
Mladý chlapec v bílém tričku si hraje na travnaté pláni.	Žena si nechává dělat vlasy v salónu.
Několik lidí v noci posedává okolo ohně.	Skupina lidí v noci postává a posedává kolem na zemi.
Černobílý pes běží s otevřenou tlamou.	Černobílý pes plave v modré vodě.
Žena v džínách hraje video hru před velkou obrazovkou.	Muž a žena pózují pro fotografa před postelí posypanou žlutými květinami.
Mnoho fotbalových hráčů sedících na zemi.	Pes se válí po zemi.
Skupina lidí kempuje venku na nějaké skále.	Skupina lidí stojí vedle hasičského vozu.
Dva psi běží na trávě.	Dva psi běžící v blátě.
Černý pes běží v trávě.	Černohnědý pes běžící v trávě.
Velký hnědý pes skáče skrz vysokou trávu.	Dívka oblečená v modrém tričku běží skrz vědecké centrum.
Černý pes honí červené frisbee.	Černý pudl běží ve sněhu.
Černobílý pes běžící mezi nějakými červenobílými stožáry.	Černobílý pes stojící na zadních nohách v obýváku.
Mladý muž a žena sedící venku na lavičce se líbají.	Muž a žena sedící na lavičce se líbají.
Dvě ženy sedící na lavičce, mají zakryté tváře, jedna žena drží nafukovacího tygra a druhá má kostým Sněhurky od Disneyho.	Dívka sedí na lavičce a drží nafukovacího tygra, sedí vedle jiné dívky v barevném oblečení.
Mladá dívka s nasazeným růžovým kloboukem se žlutou budovou v pozadí.	Mladá dívka v růžových šatech s něčím v ruce.
Černobílý pes běží v trávě.	Černobílý pes běží přes trávu.
Hnědobílý pes běží po trávě.	Béžovočerný pes běží přes trávu.
Malý chlapec v županu sedí na kovové židli.	Chlapec v županu sedí na židli.
Hnědý pes leží na modrém prostěradle.	Hnědý pes a dva černí psi v zarostlé travnaté ploše.
Černý pes s nasazeným oranžovým obojkem je zapletený v rybářském vlasci.	Černý pes s nasazeným červeným obojkem ze sebe oklepává vodu.
Tři chlapci hrající hru běží po pláži.	Dva mladí chlapci a jeden mladý muž běží po pláži s vodou za nimi.
Žena v růžových bikinách leží na lehátku přikrytém růžovým ručníkem.	Žena v bílém tričku a černé sukni na tenisovém kurtě.
Tři malé dívky sedí na trávě.	Dva pudlové běží sněhem.
Dva psi bojující ve sněhu.	Dva psi si hrají ve sněhu.
Dva psi hrající si ve sněhu.	Dva psi hrající si v trávě.
Osoba, která je ve vodě na pláži, zatímco slunce zapadá.	Osoba nad příbojem ve vodě.
Tři psi si hrají ve vodě.	Tři psi běží ve sněhu.
Černý pes stojící v trávě kousek od volejbalového míče.	Hnědočerný pes s modrým obojkem na travnatém hřišti kousek od fotbalového míče.
Tři ovce se pasou na louce se psem jdoucím za nimi.	Malá skupina koz v trávě s černobílým psem v pozadí.
Muž se houpe na laně nad vodou.	Muž v teplém oblečení se v noci houpe na prolézačkách.
Několik lidí v noci sedí okolo ohně.	Skupina lidí v noci sedí kolem planoucího ohně.
Zlatě zbarvený pes skáče kolem v trávě, zatímco drží klacek v tlamě.	Černý pes běží přes trávu nesoucí něco červeného v tlamě.
Skupina lidí na shromáždění mávající americkými vlajkami.	Dav lidí na venkovní události.
Malý červenošedý pták sedí na stromě mezi holými větvemi.	Červenošedý pták sedí ve větvích.
Černý pes běžící vodou.	Černý pes běží nějakou vodou.
Malý černý pes je v trávě.	Černý pes běží v trávě.
Skupina turistů, odpočívá před horou.	Několik turistů s jejich vybavením odpočívá před horou.
Žlutý pes si hraje na travnaté ploše nedaleko kytek.	Dívka se houpe na houpačce.
Černobílá fotka ženy ukazující na koně.	Černobílá fotka krav v kravínu.
Černý pes vyskakuje z vody.	Černý pes ze sebe oklepává vodu.
Mladý chlapec skákající do vzduchu na pláži.	Chlapec skákající do vzduchu na pláži.
Dva surfaři jedoucí na malé vlně.	Dva surfaři provádí triky ve vlnách.
Bílý pes běží přes sníh.	Bílý medvěd jde po sněhem pokryté zemi a vrhá stín do sněhu.
Usmívající se žena s pivem sedí venku s další usmívající se ženou.	Dvě smějící se ženy sedí venku.
Černobílý pes běží na pláži.	Černohnědý pes běží sněhem.
Černobílý pes běží skrz pole krav.	Velký černobílý pes běží ve vodě oceánu.
Žena jede na hnědém koni.	Mladá dívka jede na hnědém koni.
Mladá dívka běžící na pláži.	Malá dívka běžící na břehu pláže.
Starý muž v černém trikotu stojící na tržišti.	Dítě na sobě s červeným tričkem jdoucí po náměstí.
Dvě kočky koukají na okno.	Bílá kočka koukající z okna.
Muž stojící na vrcholu rozeklané skály poblíž oceánu.	Muž stojí na vrcholu skály s výhledem na oceán.
Dívka drží žlutý balónek ve tvaru zvířete.	Dítě drží žlutý balónek.
Pes běží přes pole.	Pes běhá přes pole.
Pes s plandavýma ušima jdoucí směrem k fotoaparátu v lese.	Dítě před vlastním odrazem se otáčí na kameru a usmívá se.
Muž oblečený v šedé bundě stojící na straně ulice.	Chlapec oblečený v modré záchranné vestě se drží na straně zelené lodě.
Pes v tričku se supermanem spí na dece.	Hnědý pes v tričku se supermanem leží na modré dece.
Tři psi běží v poli.	Dva psi běží v travnatém poli.
Černý pes běží ve sněhu.	Černý pes plave s míčem v tlamě.
Hokejový brankář ležící na ledu před brankou.	Hokejový hráč leží na ledu před bránou.
Pes běžící přes písek.	Pes běžící vodou.
Muž aportuje se dvěma hnědými psi.	Žena si hraje s hnědým psem.
Skupina teenagerů skáče do vzduchu na pláži.	Skupina mladých lidí, vyskakuje do vzduchu, zatímco jsou na pláži.
Starší muž s baretem na hlavě s horami v pozadí.	Ovce v ranní mlze se stromy v pozadí.
Chlapec hraje baseball.	Muž hraje baseball.
Snowboardista skáče do vzduchu.	Snowboardista letí vzduchem.
Mladá smějící se dívka a chlapec hrají na velký buben.	Mladá dívka a malý chlapec stojí u kytary a bubnu.
Béžovo bílý pes běží v poli.	Hnědobílý pes běží skrz pole.
Děti si hrají na trampolíně ve sněhu.	Několik dětí skákajících na trampolíně ve sněhu.
Muž se drží držadla ve vodě.	Muž se drží držadel ve vzduchu.
Dívka v růžových šatech jede na kole podél bílého kolíkového plotu.	Dívka v červených šatech jede na kole před bílým plotem.
Starší muž v modrém tričku drží umělecké plátno.	Černoch jde ve velkém městě vedle budovy.
Malé děvče drží dřevěný klacek.	Malé děvče plavající v bazénu.
Malý bílý pes s kudrnatými chlupy běží přes chodník s klackem v tlamě.	Bílý pes s kudrnatými chlupy běží s klackem v tlamě.
Dva psi sbíhají po pláži.	Dva psi běžící na pláži.
Muž jede na kole ze zaprášeného kopce.	Cyklista sjíždí dolů po zábradlí.
Dva lidé oblečení v bílém stojící na travnatém poli.	Muž stojí pod přejezdem blízko dálnice.
Dva psi běží trávou kousek od domu a stromů.	Dva psi běží přes zelený dvorek.
Mnoho lidí je na pláži nedaleko budovy s vlající vlajkou.	Lidé roztroušení na rušné pláži sledující oblohu.
Muž nese krabici s nářadím po chodníku.	Žena jede na modrém kole v parku.
Lidé stojí na eskalátoru jedoucím nahoru.	Lidé jedou nahoru na eskalátoru.
Bílý pes se světlehnědými značkami má klacek v tlamě a tlapy ve sněhu.	Bílý pes drží klacek v tlamě, zatímco běží sněhem.
Malý bílý pes přelézá kládu.	Malý pes překračuje kládu.
Černobílý pes nese klacek v tlamě.	Černobílý pes, má klacek v tlapách.
Skupina mužů hrajících na dechové nástroje.	Skupina chlápků hraje venku na nástroje.
Hnědočerný pes skáče, aby chytil červený míč.	Hnědočerný pes, skáče, pro červený míč.
Hnědý pes běží směrem k fotoaparátu na prašné stezce s horami v pozadí.	Hnědý pes běží dolů směrem ke kameře po skalní stezce skrz křoví s horami v pozadí.
Hnědý pes nesoucí klacek v tlamě.	Pes plavající s klackem v tlamě.
Muž na kole sjíždí úzkou cestu.	Muž na jednokolce sjíždí zpevněnou cestu.
Člověk v modré košili opírající se o kávový stolek u televize.	Člověk stojící na motorce jede po zadním kole.
Žena sedí na chodníku s mobilním telefonem u ucha.	Žena jede na kole.
Sova má své křídla nahoře a roztažené v průběhu dne.	Pták v průběhu letu má své křída roztažené.
Mladá dívka se klouže na klouzačce.	Mladá dívka se houpe na houpačce z pneumatiky.
Žena hrající tenis a trefující míček.	Žena hraje volejbal.
Černo hnědý pes běží lesem.	Pes běží lesem.
Zlatý pes běží sněhem.	Smečka psího spřežení táhnoucí sáně městem.
Býk stojící na poli.	Hnědý kůň stojí na luxusním zeleném poli.
Japonský šermíř skáče do vzduchu.	Žena učí svého psa skákat do vzduchu.
Muž sedící v doku kouká na vodu.	Muž skáče ze skály do vody.
Černé a bílé krávy se zastavily před bránou.	Černá a hnědá kráva stojí na pláni před vykořeněným stromem.
Dvě mladé dívky, jedna se usmívá.	Holčička na dětské houpačce.
Dvě malé dívky si hrají na trampolíně.	Dva malí chlapci si hrají na hřišti.
Dívka skáče v skákacím hradě.	Dívka v kostýmu tancuje jako muž.
Skupina lidí před červeným hasičským vozem.	Skupina lidí stojí okolo červeného hasičského vozu.
Muž v modrém tričku běhá na stadionu.	Muž v modrém klobouku a tričku jede na bílém koni.
Dva černí psi si hrají na trávě.	Dva černí psi si hrají na travnaté planině.
Tři psi ve sněhu u ohrady.	Dva psi pijí vodu v jezeře.
Dva černí psi hrající si ve sněhu.	Černý pes, hrabe ve sněhu.
Toto je zpětný pohled ze sportovního auta Chevrolet.	Zpětný pohled z červeného konceptu vozu Chevrolet.
Dvě ženy skáčou z houpačky.	Dvě dívky skáčou z houpačky.
Lyžař sviští sněhem.	Hnědý pes nesoucí létající talíř běží sněhem.
Dva muži na lodi plují na vodě.	Velká zelená loď pluje na vodě.
Skupina lidí stojí u okna a něco sleduje.	Skupina lidí stojí a čeká, až něco uvidí.
Pes je ve vzduchu nad trávou.	Pes leží na posteli s modrým povlečením.
Chlapec tlačí vůz se dvěma dýněmi.	Dítě si dřepne za vůz se dvěma dýněmi v něm.
Velký šedý pes si hraje v hlubokém sněhu.	Čtyři psi, hrající si ve sněhu.
Černý pes aportuje ve sněhu.	Skateboardista skákající na ulici.
Postarší žena stojí v kuchyni se dvěma kočkami u jejích nohou.	Starší paní stojící v kuchyni se dvěma kočkami u jejích nohou.
Osoba na BMX kole.	Muž na kole ve vzduchu.
Opálená dívka v květinových bikinách plave v temně modrých vodách.	Holčička v květovaných plavkách běží v písku na pláži.
Pes stojící ve sněhu vedle modrého plotu.	Tří psi si hrají v mělčině vedle skalnatého pobřeží.
Mnoho lidí závodí v ulicích.	Štěně běžící po ulici.
Velký hnědý pes se krčí v travnatém poli.	Hnědý pes běží v poli.
Červený doubledecker jede dolů ulicí.	Červený dvoupatrový autobus jede dolů ulicí.
Dva psi běží přes travnatou plochu.	Dva psi běží přes travnaté pole.
Žena zpívá do mikrofonu vedle muže hrajícího na kytaru.	Žena zpívá do mikrofonu s kytaristou v pozadí.
Velká skupina lidí stojících venku před budovou.	Skupina lidí bruslí ve velkém městě.
Skupina lidí jí venku u stolu.	Skupina postarších lidí pózuje okolo jídelního stolu.
Skupina lidí nafukuje horkovzdušný balón.	Velká skupina lidí jedoucí na hnědých a bílých koních.
Usmívající se žena stojící před stromy.	Muž jde vedle stromů před panoramami města.
Dítě v červeném kabátu leží na červené podložce.	Batole je připravené vylézt na kus červeného vybavení.
Muž stojí na vrcholu skály nebo hory a sleduje západ slunce.	Muž stojící na horách sledující západ slunce.
Tři mladé ženy stojící pospolu v pokoji.	Dvě indické ženy se dvěma indickými holkami blízko vody.
Mladý sedící muž v klobouku si čte v kavárně.	Žena, kterou těší čtení v kavárně.
Pes oblečený v zeleném svetru a s batohem jdoucí na sněhu.	Malý pes oblečený v zeleném svetru a s batohem jde sněhem.
Muž a žena jedou po ulici na kolech.	Muž a žena jedou přes křižovatku ve městě na kolech.
Černý pes jde po trávě s klackem v tlamě.	Chlapec drží síť s hadem kousek od země.
Světlehnědý pes šťastně běží po cestě.	Bledý pes sbíhá po cestě.
Skupina lidí stojí na ulici.	Žena oslovující rozmanitou skupinu lidí stojící na ulici.
Skupina mužů jde a visí na lanech.	Skupina mužů hraje vysokoškolský fotbal.
Žena oblečená v zeleném si hraje se svým bronzovým psem.	Bronzový pes olizuje dívce ruku, zatímco leží na zemi.
Mladý kluk, v hnědé bundě si hraje se sněhem.	Dva psi si hrají ve sněhu.
Žena vede psa skrz překážkovou dráhu.	Žena vedoucí jejího malého psa skrz překážkovou dráhu.
Muž v červenočerném, trefuje fotbalový míč hlavou.	Muž v červeném pruhovaném fotbalovém dresu odehrává míč hlavou.
Pes, má hlavu uvnitř červenozelené dárkové tašky.	Mazlíček hravě prozkoumává obsah dárkové tašky.
Dva hnědí psi se navzájem honí ve sněhu.	Dva hnědí psi si hrají spolu ve sněhu.
Muž stojí na břehu trefující míč pádlem.	Dvě mladé dívky stojí na pláži a poslouchají iPody.
Černobílý pes plavoucí v čisté vodě.	Malý černobílý pes plave ve vodě.
Černobílý pes běží přes pole.	Černobílý pes běží v trávě.
Dalmatin běžící podél pláže.	Dalmatin běží podél pláže.
Hnědobílý pes běží přes hnědé hřiště.	Člověk visící ze skalnatého útesu.
Muž oblečený v černé uniformě jedoucí na motorce.	Bílá motorka je řízena kolem závodní dráhy.
Žena v černých šatech se usmívá před stříbrným nákladním autem.	Dívka oblečená v černém topu se usmívá a za ní je stříbrné nákladní auto.
Muž a dva mladí kluci skáčou na trampolíně.	Muž a dva kluci skáčou na trampolíně.
Dva velcí pudlové si hrají ve sněhu s hračkou.	 Dva psi bojující ve sněhu.
Chlapec dělá triky na skateboardu.	Chlapec dělá trik na skateboardu.
Žena drží postroj, který má na sobě oblečený hnědobílý pes.	Muž a žena, se dívají na umělecké dílo, které je na podstavci připnuté k ohradní zdi.
Černobílý pes má doširoka otevřenou tlamu.	Černobílý pes, skáče do sněhu.
Dva bílí psi prochází skrz hluboký bílý sníh.	Dva bílí psi prochází skrz obrovský násep horského sněhu.
Dvě štěňata hrající si s plastovou taškou.	Dva psi hrající si na dvorku.
Malý chlapec skákající z židle na židli.	Mladý chlapec skákající z židle na židli v jeho domě.
Smějící se žena je na pláži pohřbená v mořských řasách.	Dívka v kovbojském klobouku s ovcí na vodítku.
Muž skáče do vody.	Muž je ve vzduchu.
Klauni zaujmuli švihácký postoj pro kameru.	Dítě v oranžovém je na plováku ve vlnách.
Skupina lidí, stojící mimo budovu.	Velká skupina lidí, kteří vytvořili linii venku.
Plavec plave znak v bazénu.	Člověk plavoucí znak v bazénu.
Muž sedí s malou holčičkou v parku.	 Muž si hraje s chlupatým malým psíkem.
Bílohnědý pes si oklepává uši.	Hnědý pes běží přes písek.
Skupina teenagerů tancuje na dřevěné podlaze.	Skupina lidí v tmavém oblečení tancuje v řadě na dřevěné podlaze.
Pes běží po trávě.	Hnědý pes běží v trávě.
Chlapec houpající se na houpačce.	Mladý chlapec houpající se na houpačce.
Dvě štěňata hrající si kolem v trávě.	Dva psi zápasí v trávě.
Lyžař má na sobě modré oteplovací kalhoty, letí vzduchem poblíž skokánku.	Lyžař stojí na ruce na sněhu před videokamerou.
Je tam černý pes skákající do plaveckého bazénu.	Černý pes skáče do plaveckého bazénu.
Bílý pes běžící ve sněhu.	Psi běží ve sněhu.
Tři děti hrající si na podlaze s hračkami.	Tři děti sedící na podlaze hrající si s několika hračkami.
Žena sedí ve vodě.	Žena bruslí v parku.
Černohnědý pes jde sněhem nedaleko budovy.	Starší muž stojí venku před starou zabedněnou budovou.
Chlapec a dívka si hrají na pláži.	Pes hrající si ve vlnách s míčem.
Dvě hrající si dívky s lidmi a květinami za nimi.	Dvě mladé dívky v sukních si hrají na zahradě.
Mladý chlapec si hraje v jámě s červenými míčky.	Smějící se chlapec leží v jámě s modrými balónky.
Hnědý pes žvýká oranžový míček.	Pes má oranžový míček v tlamě.
Pes je na pláži kousek od míče.	Chlap jde na basketbalové hřiště dočasně vyřazené z provozu.
Počítač od Applu stojí na podlaze.	Počítač Macintosh stojí na podlaze.
Dívka v jezeře švihá s jejími dlouhými, mokrými vlasy.	Osoba jedoucí na špinavém kole.
Dáma běží se svým psem na kurzu hbitosti.	Trenér běží se svým psem na tréninkovém kurzu v zelené trubce.
Muž v bílém obleku jde ulicí držící noviny.	Muž v bílém obleku jde venku držící noviny.
Dívka má na sobě oblečenou fialovou šerpu sladěnou se sukní.	Skupina dívek stojí oblečené v džínových sukních a tričkách se supermanem.
Dlouhosrstá kočka se zavřenýma očima.	Detail kočky se zavřenýma očima.
Cyklista skáče na kole mezi dvěma kameny.	Muž skáče na kole ve vzduchu mezi dvěma kameny.
Muž na pláži rozstřikuje tekutinu z dlouhé hadice.	Chlap sedí na kole s jedním kolem ve vzduchu.
Hnědý pes kope díru před rostlinou.	Skupina lidí jdoucí podél železniční trati.
Pes běží skrz pole a pronásleduje míč.	Dítě běží skrz trávu.
Žena držící černou peněženku kouří cigaretu.	Žena s černou taškou kouří cigaretu.
Žena v černých šatech jdoucí po ulici.	Žena sleduje psa, jak skáče ze schodů.
Malá blondýnka stojí před fontánou.	Mladá dívka stojící před fontánou.
Skateboardista dělající trik na kamenné zdi.	Skateboardista jedoucí do svahu.
Tři děti si venku hrají se senem, házející ho na čočku od foťáku.	Tři mladé děti si hrají se senem, házející ho na fotoaparát.
Pár psů hrající si s fialovým míčem.	Dva psi si hrají s fialovým fotbalovým míčem.
Skupina lidí dávající pozor na vodu stojí v písku.	Skupina lidí stojí na pláži před nějakými loděmi.
Malý chlapec blbne s cedníkem na hlavě.	Chlapec s kovovým cedníkem na hlavě.
Chlapec si hraje s nudlí u bazénu.	Chlapec si hraje s pěnovou nudlovou hračkou u bazénu.
Mladý nadhazovač hází basebalový míček.	Hnědý pes jde po trávě vedle plotu.
Žena ležící naproti dvěma mužům, kteří sedí na gauči.	Muž a dvě ženy usmívající se na kameru zatímco sedí na modrém gauči.
Mladý chlapec jede na kole.	Mladá dívka ležící na modré nafukovací hračce.
Dva chlapci hrající hru s fotbalovými vlajkami.	Dva chlapci hrají hru s fotbalovými vlajkami.
Muž s dlouhými vlasy se dívá skrz fotoaparát.	Žena stojí naproti zdi, poblíž které je video kamera.
Pes setřásající vodu.	Pes setřásá vodu.
Holčička chodí po promenádě s modrými kupolemi v pozadí.	Muž přejíždí překážku na kole s řekou v pozadí.
Muž a žena dívající se do kamery.	Smějící se muž a žena.
Žena sedí sama naproti cihlové zdi.	Žena se prochází se svojí červenou taškou.
Muž bez trička hrající fotbal na trávníku.	Muž bez trička chytá fotbalový míč.
Mokrý černý pes s červeným obojkem je v řece.	Černý pes s červeným obojkem brodící se vodou.
Stříbrnomodrý vlak Amtrak na kolejích blízko vlakové stanice.	Malé auto zaparkované u benzínové stanice.
Muž vyfoukává velké bubliny.	Muž venčící velkého černého koně.
Skupinka mladíků plave v jezeře.	Mnoho dětí si hraje a plave ve vodě.
Mladá blonďatá holka s helmou sedí s červeným kolem za ní.	Mladá dívka s helmou s kolem v pozadí.
Velmi přeplněný kancelářský stůl s počítačovým monitorem.	Zaneřáděný počítačový stůl se dvěma monitory.
Hnědobílý pes zanechává ve sněhu stopy.	Černobílý pes skotačí ve sněhu.
Muž s batohem se dívá doleva.	Dospělý muž s batohem jde a dívá se doleva.
Mladý chlapec skáče do bazénu s roztaženýma rukama.	Pes skáče do bazénu na dvorku.
Černohnědý pes si hraje na dvorku.	Černo bronzový pes honí něco, co spatřil.
Dva psi běží na trávě před stromy.	Hnědý pes běží na trávě před nějakými stromy.
Dívka s černou kabelkou sedící na dřevěné lavičce.	Mladá žena s černou kabelkou sedí na dřevěné lavičce.
Bílý pes si hraje s míčem na pláži.	Černobílý pes si hraje s béžovým psem.
Pes skáče do plaveckého bazénu za kachnou.	Pes skákající do plaveckého bazénu.
Loď vplouvá do divoké vody.	Muž na kajaku sjíždí divokou vodu.
Černý pes běžící sněhem.	Černý pes běžící vodou.
Modrý gauč a dvojitá postel v obýváku.	Modrý gauč v pokoji se sluncem svítícím dovnitř.
Pes vrací hračku svému pánovi.	Tři psi spolu závodí ve sněhu.
Chlapec leží na břiše v trávě.	Malý chlapec ležící na břiše na trávě.
Hnědý pes dává odpočinout svým tlapám na klávesnici notebooku.	Pes i se svými tlapami sedí na notebooku.
Bílí pes jdoucí ve sněhu.	Černo žluto hnědý pes jdoucí sněhem.
Beránek dívající se na kameru.	Malý ptáček stojící na kládě, která je u břehu.
Černá kráva na pastvě jdoucí pod stromy.	Kráva na pastvě jdoucí pod stromem.
Lyžař jede dolů zasněženým kopcem.	Hnědý pes leží ve sněhu.
Mladý chlapec v červeném zimním kabátu drží a jí tyčinku.	Mladý chlapec v červeném kabátu jí čokoládovou tyčinku.
Chlapec skočí do modré bazénové vody.	Mladý chlapec skáče do bazénu po břiše.
Dva dělníci sedí na nosníku a dávají si pauzu.	Muž si obléká triko u výtahu.
Mladý chlapec skákající do jezera.	Chlapec skáče do jezera.
Muž skáče z jedné střechy na druhou.	Mladý muž skáče z jednoho balkónu na druhý.
Tento pes skáče přes vodu.	Dva psi, běžící vodou po pláži.
Žluté auto zrychluje po zasněženém poli.	Žlutý vůz jede rychle ve sněhu.
Dva lidé sedí u stolu v restauraci.	Čtyři lidé sedí u stolu.
Nemluvně sedící na lůžku se se natahuje, aby se dotklo obličeje staršího chlapce.	Obličeje nemocně vypadajícího chlapce, se dotklo batole.
Starší žena jede na kole po ulici ve městě.	Starší žena jdoucí do kopce přecházející ulici.
Tři lidé stojí ve venkovní, skleněné stavbě.	Dívka stojí vysoko na plošině překážkové dráhy.
Muž oblečený v černém oblečení, klobouku a brýlích před červenou zdí.	Žena v bílém tričku stojící před cihlovou zdí.
Černobílá ovce jde vedle bílé ovce.	Malé černobílé tele se značkou v uchu.
Německý ovčák skáče skrz černou obruč, zatímco se lidé koukají.	Pes skáče skrz obruč.
Skupina čtyř dětí tancujících na dvorku.	Skupina dětí se protahuje na barevných podložkách.
Dívka skáče.	Chlapec leze po skále.
Muž sedí na vrcholku skalnaté hory.	Člověk vystrkuje hlavu ze stanu na vrcholu hory.
Dva psi na pláži.	Pes jde na pláži.
Pes a kočka leží spolu.	Dva šedí psi nesou klacek ve vodě.
Mokrý, zlatosrstý pes nese klacek na pobřeží.	Mokrý, hnědý pes má klacek v tlamě a běží v písku kousek od vody.
Chlapec se zlomenou rukou odpočívá v posteli.	Chlapec se zlomenou rukou spí.
Mladý chlapec běžící po chodníku.	Černý pes běžící podél oceánu.
Hnědobílý pes s růžovým létajícím talířem v tlamě hopsá muži po zádech.	Pes s létajícím talířem v tlamě přeskakuje muže.
Hnědý pes běží po travnaté cestě.	Hnědý pes běží po travnatém úseku děleným řetězem.
Hnědý pes běží na sněhu se sněhovou koulí v tlamě.	Čtyři psi si hrají na sněhu s panoramou města za nimi.
Tmavě hnědý kůň stojící na poli.	Hnědý kůň stojí na luxusním zeleném poli.
Mnoho lidí ze středního východu sedí v zadní části modrého vozu.	Skupina lidí jede v zadní části kamionu.
Muž s rybářskými pruty sedí v blízkosti vodního toku.	 Muž sedí na kameni vedle skládacího sedátka a rybářského prutu.
Hnědý pes běžící na trávě.	Pes běží na trávě.
Žena ve velkých slunečních brýlích drží noviny v obou rukách.	Tlustá žena v slabém modrém topu fouká mýdlovou bublinu.
Černý pes hravě kouše světlehnědého psa do ucha.	Černý pes hravě kouše jiného psa v prostředí obývacího pokoje.
Bílo hnědý pes běží přes trávu.	Hnědobílý pes běží přes trávu.
Skupina koní pasoucí se na travnatém poli.	Skupina koní pasoucí se na poli.
Žlutohnědý pes běží přes listy.	Bílý pes běží přes oceán.
Hnědý pes běží přes pole.	Hnědý pes s třepajícím se jazykem, jak běží přes pole.
Černobílá fotka gauče s peněženkou na jednom konci.	Černobílá fotka krávy pod stromem.
Člověk se protahuje otvorem ve skále.	Středně velký hnědý pes běží přes otevřené bílé zalesněné oblasti.
Hnědobílý pes jde vedle muže na skateboardu.	Blonďaté dítě leží na větvi stromu na zelené louce.
Detail lahve s vodou.	Detailní pohled na lahve s vodou.
Dva muži nastavují nějaké elektrické zařízení.	Dva psi zápasí na zemi ve sněhu.
Dva psi hrající si ve sněhu.	Dva černí psi ve sněhu.
Dva bílí psi jdoucí ve sněhu.	Žluto hnědý pes s černým obojkem štěkající ve sněhu.
Muž v šedém obleku zamykající kolo.	Muž a žena stojící na ulici města.
Muž se šedivým plnovousem jezdí na kole na pláži oceánu.	Skvrnitý pes stojí na zadních nohách a chytá míč na pláži.
Zlatosrstý pes ve sněhu chytá míček do tlamy.	Malá blondýnka sedí na zelené židli.
Dívka skákající přes švihadlo na chodníku poblíž garáže.	Dívka skákající přes švihadlo na chodníku s garáží na levé straně.
Černobílý pes běží vodou.	Černohnědý pes běží polem.
Dva mladí lidé bez trička, hrající si ve vodě.	Mnoho lidí si hraje ve vodě na pláži.
Jehně dívající se do kamery.	Kočka dívající se do kamery.
Muž ujíždí na kitesurfu pryč od kamery.	Muž dělá skysurfing na vodě.
Hnědé chlupaté zvíře stojí za nějakými rostlinami.	Pes kouká, zatímco stojí v lese.
Zrzavá žena v černém pózuje pro muže, který odpočívá na stromě.	Muž v černém tričku drží dítě, které má sluneční brýle.
Miminko v červené čepici sedící v kočárku, drží panenku.	Muž v šedém tričku sedící v poli květin.
Černý pes běžící do vody.	Černý pes běžící vodou.
Muž jede na kole po blátivé cestě.	Dva psi, běžící po blátivé cestě.
Mladá dívka vztyčí znamení míru.	Holčička se na ulici drží tyče.
Žena spí v sedu, s hlavou opřenou o ruku.	Muž, který odpočívá s hlavou položenou na ruce.
Mladý chlapec jedoucí na kole na cihlové silnici.	Člověk dělá triky na kole na rampě obklopené stromy.
Muž a žena jdoucí kolem obchodu s hudbou.	Muž a žena líbající se před davem lidí.
Dva chlapci, jeden s kloboukem, na hřišti.	Chlapec v béžovém klobouku se směje, zatímco sedí poblíž vybavení hřiště.
Černobílý pes běžící vodou.	Žluto hnědo bílý pes běží vodou.
Skupina čtyř lidí jí dort po večeři.	Čtyři lidi jí dezert u stolu.
Mladé dítě, se klouže po oranžové skluzavce.	Malý chlapec v džínové kombinéze se klouže po oranžové skluzavce.
Dva koně stojící v poli se stromy v pozadí.	Černobílý pták na vodě s trávou v pozadí.
Mladá dívka jede na bílošedém koni.	Mladá blonďatá dívka v jezdeckém úboru sedí na hřbetu šedobílého koně.
Dvě dívky v modrých a zelenomodrých šatech s velkými klobouky stojí vedle velkého kmene stromu.	Žena, malý chlapec a malé dítě stojí před sochou krávy.
Člověk na lyžích se nechává táhnout psy na horách.	Hnědý pes si hraje s míčem ve vodě.
Dvě děti jdou po cestě v lese.	Dvě děti jdoucí po cestě v lese.
Pes běží s jídlem v tlamě.	Pes běží se žlutým míčem v tlamě.
Mladý chlapec stojí na šedivé keramické dlažbě.	Mladý chlapec procvičující karate v tělocvičně.
Muž s boxerkami s vlajkou US stojí na schodišti.	Žena v bílém tričku stojí na ulici.
Žena s mladou dívkou pózují se sochou medvěda v přední části prodejny.	Muž v dresu stojí před velkým davem.
Tři děti stojí na plotu nebo v jeho blízkosti.	Tři děti stojí na plotu a u něj.
Dva hnědí psi se navzájem koušou.	Dva hnědí psi v písku kousající se navzájem.
Žena v červených montérkách, stojící na chodníku.	Žena v červených montérkách stojí na chodníku.
Pes běží přes dvorek plný listů.	Tři psi běží přes pole.
Dva psi běží na travnaté ploše.	Dva psi běží přes travnatou plochu.
Vyhublé krávy stojí na trávě.	Bílé kachny stojí na zemi.
Dívka stojí v metru čekající na něco.	Dívka stojí v temném prostoru.
Děti si hrají v bazénu, zatímco dva dospělí muži na ně dávají pozor.	Děti si hrají v bazénu, zatímco dospělí přihlíží.
Jelen skáče plot.	Jelen skáče přes plot.
Černý pták sedí na zemi.	Černý pták sedí na zemi.
Hnědý pes běžící špinavou blátivou trávou.	Velký hnědý pes běží venku ve špíně.
Dva psi, se k sobě přiblížili v trávě.	Dva psi, stojí proti sobě na trávě.
Mokré dítě se třese pod ručníkem u bazénu.	Mokré dítě se třese v ručníku před bazénem.
Muž řídí modrou loď kolem pestrobarevných domů.	Muž řídící modrou loď proplouvající kolem pestrobarevných domů.
Dva psi se dělí o hračku v poli vegetace.	Dva snowboardisté jsou ve vzduchu nad sněhem.
Holčička s mašlí ve vlasech si vybírá nos.	Holčička s helmou ve fialovém tričku jede na koloběžce.
Muž ve fraku jede na kole po zpevněné cestě.	Muž pomocí velké tyče odstraňuje písmena ze značky.
Šedý pes plavoucí přes řeku s klackem v tlamě.	Pes plavoucí přes vodu nesoucí klacek v tlamě.
Stan a kemp v prosluněném lese.	Bílý pes na pláži nese klacek v tlamě.
Žena v černém triku stojí před banány u stánku s ovocem.	Žena oblečená v černém stojí před dodávkou.
Černý pes stojící před žlutými kytkami.	Černý pes stojící na poli.
Maskovací letadlo stojící na travnatém poli.	Maskované letadlo stojící na zelené trávě.
Malý bílý pes a velký hnědý pes si hrají na trávě.	Malý světlehnědý pes běží kolem velkého hnědého psa stojícího v trávě.
Tři psi hrající si ve sněhu.	Chlapec si hraje v písku.
Dva turisté stojí na vrcholu zasněžené hory.	Dva horolezci stojí na vrcholu hory a rozhlížejí se kolem sebe.
Žluto hnědo bílý pes získává míček na štěrkové cestě.	Velký pes jde v lese po štěrkové cestě.
Dva chlapci hrající si na hřišti.	Dva lidé mají hlavy pokryté šátky.
Dva lidé jsou v posteli.	Dva boxeři jsou v ringu.
Dva lidé držící se za ruce a jdoucí v poli.	Dva muži, procházející kolem nástěnné malby auta.
Mladá dívka pózuje u sloupu s U2 cedulí.	Žena stojící u sloupu kde je napsáno U2.
Muž a pes na kamenech na pláži.	Muž a pes na kamenném mořském břehu.
Muž a pes na skalnatém mořském pobřeží.	Muž a pes stojící na kamenech vedle vody.
Skupina lidí nosí králičí uši.	Skupina lidí jede závod.
Blonďaté batole houpající se na houpačce z pneumatiky.	Blonďaté batole se houpá na houpačce z pneumatiky.
Dva muži sedí na chodníku před obchody.	Žena v plavkách venčí psa na pláži.
Domácí kancelář se třemi počítačovými monitory a ostatním vybavením v pozadí.	Místnost s pár počítačovými monitory.
Černo hnědo bílý pes běžící skrz pole.	Bílo hnědý pes běží v poli.
Muž na kole vedle řeky.	Muž na kole skáče velmi vysoko.
Pes skáče dolů po rampě.	Dívka skáče v písku.
Pes s velkýma ušima drží malý klacek v tlamě.	Štěně s velkýma ušima žvýkající klacek.
Bílý pes běžící sněhem.	Černobílý pes běží trávou.
Dva chlapci skáčou do bazénu.	Dva chlapci jsou ve vzduchu při skákání do vnitřního bazénu.
Mladá dívka oblečená v Minnie Mouse oblečení a starší žena jdou po chodníku.	Muž v bílém obleku a s novinami kráčí ulicemi.
Mladistvá dívka běžící po pláži křičí, za ní jde starší muž.	Mladé dítě běžící podél pobřeží na pláži.
Dva psi běžící na břehu.	Bílý pes běžící na pláži.
Dívka se dvěma černými psi běží podél břehu řeky.	Malý chlapec se mazlí s tygrem, který leží na zemi.
Pes plavající s klackem v tlamě.	Pes plavající ve vodě s klackem v tlamě.
Dva žluto hnědo bílí psi a jeden žlutohnědý pes závodí po pláži kousek od vody.	Dáma v růžové bundě se Zvonilkou stojí vedle zábradlí a sleduje vodu.
Žena běží po pláži.	 Pes běží přes pozemek.
Pták držící se kovové brány.	Vícebarevný pták visí na drátěném plotu.
Bígl jde po pláži na okraji vody.	Bígl se prochází podél klidného pobřeží.
Dvě děti stříkající ve vodě.	Dva psi si spolu hrají na posteli.
Dva psi si hrají v trávě.	Dva psi hrající si v trávě.
Malý pes vzhlíží k foťáku, zatímco stojí mezi stromy.	Muž a žena smějící se do foťáku zatímco stojí v kuchyni.
Žena drží dítě, zatímco muž se kouká na jiného muže držícího dětské hodinky.	Žena stojí v obchodě s rukama venku, zatímco jiná žena drží kameru.
Černo žluto hnědý pes stojící na poli kousek od stromů.	Bílý pes stojí u řeky a oklepává se do sucha.
Šest psů běžících po písečné pláži.	Šest psů jdoucích vedle pláže.
Dívka v oranžovém zapaluje svíčku.	Dívka v oranžovém tričku zapaluje svíčku.
Dvě dívky sedí před sochou.	Dvě blondýny sedí vedle sochy.
Jedno dítě tahá jiné, sedící v červeném voze, podél písku.	Chlapec táhne jiného chlapce ve směšném klobouku ve vozítku.
Zvědaví chlapci koukají do kůlny.	Dva malí kluci ve dřevěném areálu koukají do kůlny.
Bílo hnědý pes rychle běží skrz trávu.	Velký bílý pes běží v trávě.
Hnědý pes sedí na pláži.	Pes běžící na pláži.
Dívka v růžovém tričku roztahuje svoje končetiny ve vzduchu.	Muž oblečený v kostýmu Santy šplhá po velké betonové budově.
Pes si hraje v parku.	Pes skáče přes plot v parku.
Černobílý pes běžící vodou.	Černobílý pes běžící trávou.
Černobílý pes skáče do vody.	Bílý pes běží přes vodu.
Pes skáče přes řetěz.	Pes skákající přes řetěz.
Pět ptáků stojí na sněhu.	Pár kardinálů stojí ve sněhu.
Hnědý pes leží na modré přikrývce.	Člověk se potápí v průzračně modré vodě.
Dvě dívky s copy jedou v zábavním parku jízdu.	Mladá dívka je na jízdě v zábavním parku.
Bílý a černý chlapec stojí a mají ruce okolo toho druhého.	Dva mladí chlapci, jeden bílý a jeden černý, stojí a objímají se.
Mladý chlapec se stojícími vlasy se klouže po modré skluzavce.	Dítě v oranžovém tričku se klouže po modrozelené skluzavce.
Dvě dívky na břehu pozorují lidi v rybářské lodi.	Dva muži, jeden v červeném a jeden v bílém hrající basketbal.
Velký černobílý pes plave ve vodě.	Černobílý pes s klackem je v blátivé vodě.
Černý a bílý pes hrající si na ulici.	Černý a bílý pes hrající si spolu na ulici.
Hnědý pes v běhu na trávě.	Hnědý pes běží trávou.
Detail kočky s hnědým obličejem.	Detail pštrosí tváře.
Dva psi bojující ve sněhu.	Dva psi hrající si ve sněhu.
Černobílá kočka ležící pod křovím.	Černobílá kočka se žlutýma očima lenoší ve špíně.
Bílý pes s červenýma ušima běží ve sněhu.	Mokrý černý pes s červeným obojkem je v řece.
Dva závodní psi, běží v blátě.	Muž jde do vody.
Bílo hnědý pes běží přes trávu.	Hnědobílý pes běží napříč trávou.
Dva lidé jdoucí na pláži při západu slunce.	Dva lidé jdoucí po pobřeží při západu slunce.
Muž jedoucí na vlně na surfu.	Muž v černém jedoucí na vlně na surfu.
Muž ve slamáku zastiňuje svůj mobil, zatímco ostatní jdou po rušném chodníku.	Muž leží na ulici s jeho hlavou a rameny pod zaparkovaným autem, které zvedá.
Muž a dvě ženy oblečeni v upířích kostýmech.	Muž a dvě ženy oblečeni v kostýmech.
Detail hnědé koňské hlavy.	Pohled z profilu na koňskou hlavu.
Dítě s rukama na jeho hlavě.	Malý chlapec stojí s rukama na vršku jeho hlavy.
Muž visí na laně z útesu nad vodou.	Muž sedící sám na molu s lahví vody.
Dva lidé v kombinézách ležící ve sněhu dělající andělíčky.	Dvě dětí ležící ve sněhu dělající andělíčky.
Muž se houpá na laně nad vodou.	Muž v plavkách v barvě kaštanů se houpe na laně na jezeře.
Černobílý býk dívající se do kamery.	Černobílý pes dívající se do kamery.
Dáma ve žlutém oblečení je ve vzduchu nad postelí ve žluté místnosti.	Pes s červeným vodítkem je stále zapojen do honičky po trávě za tenisovým míčkem.
Žena v černých šatech s červenými doplňky jde na ulici.	Žena v černých šatech jdoucí na ulici.
Dítě skáče s kolem na římsu.	Černobílá kočka hrající si s dekou.
Tři jednotlivci na lyžích pózují za cedulí s nápisem zákaz lyžování.	Tři lidé na lyžích stojí za cedulí s nápisem zákaz lyžování.
Chlapec houpající se na houpačce.	Dívka je na houpačce.
Žena s velkým náhrdelníkem.	Mladá žena s černým svrškem a náhrdelníkem.
Dívka se zelenými copánky s něčím v ruce.	Mladý chlapec pouze v zelených kraťasech složitě pózuje s cihlovým pozadím.
Pes s červenou hračkou v tlamě.	Hnědý pes nese klacek v tlamě.
Hráč ragby v tmavě zelené výbavě nese světle zbarvený ragbyový míč napřaženou rukou.	Hnědý pes šplouchá ve vodě, zatímco nese míč v jeho tlamě.
Dva fotbalisté bojují o míč během intenzivního utkání.	Dva malí oranžovobílí psi jsou ve sněhu.
Muž na bruslích sjíždí řadu schodů.	Muž na lyžích sjíždí zasněžený kopec.
Dva psi běží na trávě.	Dva psi si hrají v trávě.
Dva velcí hnědí psi běžící sněhem.	Hnědý pes běžící trávou.
Malý smějící se chlapec stojí v přední části svatební party.	Osoba stojící na pódiu před sedícím davem.
Dva psi si hrají v trávě.	Dva psi si hrají ve sněhu.
Osoba, která leze na zasněžené kopce, je následována jejím psem.	Osoba šplhá na zasněžené kopce, zatímco černý pes následuje.
Malý chlapec a malá dívka hrající si spolu venku.	Žena v bílém tričku stojí na ulici.
Malý bílý pes běžící přes trávník.	Běžící malý bílý pes.
Tři psi hrající si ve sněhu, zatímco jeden pes má na sobě bundu.	Tři psi hrající si ve sněhu, s městem v jejich pozadí.
Bílá ovce na straně kopce dívající se do kamery.	Vyhublé krávy stojící na trávě.
Tři psi hrající si ve sněhu.	Tři psi běží ve sněhu.
Muž lezoucí po skalní stěně.	Muž leze po skalní stěně.
Člověk v potápěčském obleku plave pod vodou.	Člověk se potápí ve velmi čisté modré vodě.
Usmívající se muž je oblečený v černém tričku a klobouku.	Muž zvedá malou dívku nad hlavu.
Dva černobílí psi si hrají spolu venku.	Dvě děti a černý pes si hrají venku ve sněhu.
Dítě oblečené v modrobílých šortkách, skáče v příboji.	Dívka se zelenými copánky s něčím v ruce.
Holčička a chlapec se drží za ruce na lesklé skluzavce.	Holčička v kašmírových šatech běží přes písečné hřiště.
Dva psi čuchají k něčemu v kamení.	Dva psi běžící po cestě v lese.
Tři muži sedí u stolu s pitím.	Tři muži sedí u stolu s pivem a jídlem.
Černý pes běží v trávě.	Černý pes běží skrz trávu.
Tato fotografie přes vrchol ukazuje dva muže dávající si pauzu.	Nadechující se osoba s koupací čepicí a brýlemi.
Holčička na jaře jede na dětské tříkolce.	Holčička si venku hraje s hračkou.
Pruhovaná kočka leží na tašce se stelivem pro kočky.	Kočka domácí leží na zádech v stelivu pro kočky.
Skupina lidí sedící okolo stolu.	Skupina dívek na pláži.
Krávy se krmí v korytu.	Černé a bílé krávy krmící se z koryta.
Pár sedící na zahradní židli v blízkosti vody.	Chlapec v parku skáče z jednoho piknikového stolu na druhý.
Dítě a dva psi si hrají ve vodě.	Dítě v červenomodrých rukávkách dívající se na vodu.
Muž cvičící box.	Muž cvičí box.
Muž v černé kožené bundě spí v metru.	Muž v černé kožené bundě, usnul ve veřejném dopravním prostředku.
Mladá žena se naklání k talíři při jídle.	Mladá žena, nahoře bez pomalovaná barvou a bahnem.
Muž zvedá velký kámen.	Žena zvedá velký kámen.
Bílo hnědý pes běží přes trávu.	Tři psi běží na trávě.
Malý kluk staví nějaké dřevěné bloky.	Malý kluk s modrým trikem kupí dřevěné bloky.
Dívka v černomodrém neoprenu surfuje.	Žena oblečená v černomodrém pruhovaném obleku surfuje na vlně.
Chlapec skákající salto vzad do plaveckého bazénu.	Chlapec v červenomodrých plavkách skákající po hlavě do plaveckého bazénu.
Černožlutý pes.	Černý a hnědobílý pes si hrají v poli.
Pes stojící ve vodě.	Dívka hrající si na padáku.
Autobus jedoucí ulicí.	Červený doubledecker jedoucí dolů ulicí.
Tři psi táhnoucí muže na kole sněhem.	Psi táhnou muže na kole skrz sníh.
Tři lidé sedí u piknikového stolu před budovou natřenou jako Union Jack.	Tři lidé sedí u venkovního stolu před budovou natřenou jako Union Jack.
Bílý pes běží podél skalnatého pobřeží.	Pes skáče přes překážku.
Muž se krčí a drží kameru.	Krčící se muž drží velkou kameru.
Tři závodící lidi na bruslích.	Tři bruslaři za rohem.
Chlapec jede dolů nafukovací skluzavkou.	Chlapec v červeném se klouže dolů nafukovací dráhou.
Surfař sjíždí lámající se vlnu.	Skupina surfařů chytající vlnu.
Žena v modrých plavkách skáče z mola do jezera.	Chlapec v modré košili a modrých džínách běží napříč hřištěm.
Muž s helmou řídící motorku blízko bílé konstrukce.	Dívka s černými kraťasy a botami, stojící vedle modré motorky.
Dva psi běží sněhem, jeden s tenisovým míčkem.	Kluk ve vzduchu dělá triky na jeho kole.
Mladý chlapec mlátí do žlutého míče.	Malý pes skáče přes žlutý paprsek.
Vemeno mléčné krávy, která stojí na pastvě blízko velké budovy.	Černohnědá kráva stojící na zelené trávě.
Tři malí chlapci se pokrývají bublinami.	Tři děti stojící u bazénu jsou pokryté pěnovými bublinami.
Muž hraje na bílou kytaru.	Muž hrající na bílou kytaru a zpívající k tomu.
Pes skáče přes překážku na soutěži hbitosti.	Pes skákající přes překážkovou dráhu.
Pes ve sněhu.	Dva psi ve sněhu.
Malý bílo hnědý pes skáče přes vodorovnou tyč.	Hnědobílý pes skáče přes červenožlutou tyč.
Hnědobílý pes s růžovým obojkem ve sněhu štěká na hnědého psa s modrým obojkem.	Pes s červeným obojkem cení zuby na psa s modrým obojkem.
Chrt je aktivní na travnatém hřišti.	Skupina kol závodících na dráze.
Dva lidé na motorce a sajdkáře závodí v bahně.	Pes nesoucí dlouhý klacek v tlamě.
Skateboardista skáče ze schodů.	Pes skáče ze schodů.
Dva psi si kolem hrají v blátě.	Tanečnice v červenobílých šatech pózující pro kameru.
Dva lidé sedí v doku kousek od vody.	Dva lidé sedí na konci doku uprostřed klidné vody.